000010000
000010000
000011100
000010100
111010111
000000000
000010000
000010110
000010010